000000000000000
000000000000000
000000000000000
000000000000000
000000000000000
000011111110000
00001O@1XO10000
00001OOVOO10000
00001OBVBO10000
00001OO1XO10000
00001OOOOO10000
000011111110000
000000000000000
000000000000000
000000000000000
