000000000000000
000000000000000
000000000000000
000000111100000
0000011@O100000
000001OBO100000
000001OOO100000
0000011OO100000
0000001BX100000
0000001OX100000
000000111100000
000000000000000
000000000000000
000000000000000
000000000000000
