000000000000000
000011111110000
00001OOOOO10000
00001OO@OO10000
00001OOOOO10000
0011111O1111100
001XOOOOOOOX100
001V11OOO11V100
001OOOOBOOOO100
001OOOXBXOOO100
001OOVBBBVOO100
001OOOXBXOOO100
001OOOOOOOOO100
001111111111100
000000000000000
