000000000000000
000000000000000
000000000000000
000000000000000
000011110000000
00001@O10000000
00001OO11110000
00001XBBXO10000
000011OBOO10000
000001OO1110000
0000011O1000000
000000111000000
000000000000000
000000000000000
000000000000000
