000000000000000
000000000000000
000000000000000
000001111100000
000001XOO100000
000001XOO100000
000001OOO110000
000001OBBO10000
000001OBOO10000
0000011O@X10000
000000111110000
000000000000000
000000000000000
000000000000000
000000000000000
