000000000000000
000000000000000
000000000000000
000000111110000
0000001OOX10000
0001111OOO10000
0001OO@B1010000
0001OBBBOO10000
0001XOOOOX10000
000111111110000
000000000000000
000000000000000
000000000000000
000000000000000
000000000000000
