000000000000000
000000000000000
000000000000000
000011111110000
00011OOOOO11000
0001OOBOBOO1000
0001OBXVXBO1000
0001O0V@V0O1000
0001O0XVX0O1000
0001OOB0BOO1000
00011OOOOO11000
000011111110000
000000000000000
000000000000000
000000000000000
