000000000000000
000000000000000
000000111000000
0000001X1000000
0000111B1110000
00001OOBOO10000
00001OOOOO10000
00001OOOOO10000
00001OO@OO10000
00001OOOOO10000
0000111B1110000
0000001X1000000
000000111000000
000000000000000
000000000000000
