000000000000000
000000000000000
000000000000000
000000000000000
000011111111000
00001OOOOOO1000
00001OX11@O1000
00001OOXBOO1000
00001OBX1B11000
00001OOOOO10000
000011111110000
000000000000000
000000000000000
000000000000000
000000000000000
