000000000000000
000000000000000
000000000000000
000011111000000
00001OOO1111000
00001O@O1XO1000
00001OO11OO1000
00001OO1OO11000
00001OOBBO10000
00001OOOOX10000
000011111110000
000000000000000
000000000000000
000000000000000
000000000000000
