000000000000000
000000000000000
000000000000000
000000000000000
000000000000000
000111110000000
0001O@O10000000
0001OBB10000000
0001OOO10011000
0001OOBO00X1000
000111110011000
000000000000000
000000000000000
000000000000000
000000000000000
