000000000000000
000000000000000
000000000000000
000000000000000
000111111110000
0001@O1OOO10000
0001OO1XOO10000
0001OO1OBO10000
00011OBO1110000
00001OOO1000000
00001XOO1000000
000011111000000
000000000000000
000000000000000
000000000000000
