000000000000000
000000000000000
000000000000000
000000000000000
000001110000000
000001@11111100
000011B1OOXO100
00001OOBOOBX100
00001OOO1OXO100
00001OOO1111100
000011111000000
000000000000000
000000000000000
000000000000000
000000000000000