000000000000000
001111100000000
001OOO111111110
001O@O1OOOOOO10
001OOO1OOXXOO10
0011O11OOOOOO10
001OOOBOOBBOO10
001OOO1OOOOOO10
001OOO1OXVVXO10
001OBO1OOOOOO10
001OOO111111110
001111100000000
000000000000000
000000000000000
000000000000000
