000000000000000
000000000000000
000000000000000
000000000000000
000000000000000
001111111111100
001OOOOOOOOO100
001O111O111O100
001OBOOVOOBO100
001OXBBBBBXO100
001OOXXXXXOO100
0011OOO@OOO1100
000111111111000
000000000000000
000000000000000
