000000000000000
000000011111000
00000001O@O1000
00000001OOO1000
00000001OOO1000
00011111BBO1000
0001XXX1OBB0000
00010001OBO0000
0001OOOBOBO0000
0001OOO1OOO0000
000111111111000
000000000000000
000000000000000
000000000000000
000000000000000
