000000000000000
000000000000000
000000000000000
000011110000000
00001OX10000000
00001OB11111000
00001OOOOB@1000
001111O1OBO1000
001OBOOOOXO1000
001OXOOXOOO1000
001111111111000
000000000000000
000000000000000
000000000000000
000000000000000
