000000000000000
000000000000000
000000000000000
000001111100000
00000OOOOO00000
00000O1O1O00000
00000OBVBO00000
0001OOXBXOO1000
000111O@O111000
000000000000000
000000000000000
000000000000000
000000000000000
000000000000000
000000000000000
