000000000000000
000000000000000
000000000000000
000000000000000
000001111000000
000001XX1000000
000001OB1100000
000001OB@100000
000001OBO100000
0000011OX100000
000000111100000
000000000000000
000000000000000
000000000000000
000000000000000
