000000000000000
000000000000000
000000000000000
000000000000000
000111111111000
0001@OBOXO11000
0001OOOBXBO1000
0001111XBXO1000
0000001OOOO1000
000000111111000
000000000000000
000000000000000
000000000000000
000000000000000
000000000000000
