000000000000000
000000000000000
000000000000000
000000000000000
000001111100000
000001OOO100000
000001O@O100000
000001OBO100000
000001XB1100000
000001XO1000000
000001OO1000000
000001111000000
000000000000000
000000000000000
000000000000000
