000000000000000
000000000000000
000000000000000
000000000000000
000000000000000
000011111111000
00001OX1@OO1000
00001OOOBOO1000
00001OOVOOO1000
000011111111000
000000000000000
000000000000000
000000000000000
000000000000000
000000000000000
