000000000000000
000000000000000
000000000000000
000000000000000
000000000000000
000111111111000
0001OXOXBOO1000
0001O1B1OO@1000
0001OOOOOOO1000
000111111111000
000000000000000
000000000000000
000000000000000
000000000000000
000000000000000
