000000000000000
000000000000000
000000000000000
000001111000000
000011@X1000000
00001OBO1000000
00001OBO1110000
00001OB1OO10000
00001XOOOX10000
000011OO1110000
000001111000000
000000000000000
000000000000000
000000000000000
000000000000000
