000000000000000
000000000000000
000000000000000
000011111000000
00001OOO1111100
00001OBO0OOO100
00001O@O0OXO100
00001OBO0OOO100
00001OOO1111100
000011111000000
000000000000000
000000000000000
000000000000000
000000000000000
000000000000000
