000000000000000
000000000000000
000000000000000
000000000000000
000011111111000
00001OOOOOO1000
00001B1111O1000
00001@O1OOO1000
00001OOBOOO1000
00001XX1OOO1000
000011111111000
000000000000000
000000000000000
000000000000000
000000000000000
