000000000000000
000000000000000
000000000000000
000011111110000
00001@O0OO10000
00001BB0BO10000
000010000010000
00001OO0OB10000
00001XB0OO10000
000011111110000
000000000000000
000000000000000
000000000000000
000000000000000
000000000000000
