000000000000000
000000000000000
000000000000000
000000000000000
000011111110000
00001OOOOX10000
00001OOOOB10000
00001OO1OO10000
00001111O110000
0000001@BO10000
0000001XOO10000
000000111110000
000000000000000
000000000000000
000000000000000
