000000000000000
000000000000000
000000000000000
000000000000000
000001111100000
000011O@O110000
00001OOOOO10000
00001OBBBO10000
000011OOO110000
000001000X10000
000001111110000
000000000000000
000000000000000
000000000000000
000000000000000
