000000000000000
000000000000000
000000000000000
000011111111000
00001@O1XOO1000
00001OOOOOO1000
00001OO1XOO1000
00001OO11OO1000
00001OBBOOO1000
00001OOO1OO1000
000011111111000
000000000000000
000000000000000
000000000000000
000000000000000
